111111111111111
1111111111P1001
1111000000E0001
100000000010001
111111110000001
100000000000001
100000000000001
111100000000001
1100000000C0101
100000000000001
111111111111111
111111111111111
111111111111111
111111111111111
111111111111111