111111111111111
11111111PC00001
100000000000001
100000000010001
111111110000001
100000000000001
1CC000000000001
111100000000001
110000000000101
1000000000E0001
111111111111111