11111111111
10000000001
10000000001
100P0010001
100C0000001
100C0000001
100E0000001
10000000001
10000000001
11111111111