11111111111
1P000000001
11000000001
10000010001
100C0000001
1E0C0000001
11111101111
11101000001
10010C00001
11111111111