11111111111
10000000001
10000000001
100P0000001
100C0000001
100C00E0001
100E0000001
10000000001
10000000001
111P1111111