1111111
1000001
1000001
1C000P1
1E0C001
1111111